type octile
height 86
width 88
map
@@@@@@@@@@@@@@@@@@@@@@@@@@@@@@@@@@@@@@@@@@@@@@@@@@@@@@@@@@@@@@@@@@@@@@@@@@@@@@@@@@@@@@@@
@.......@@......@..@..@..@@....@....@...@...@.....@@..@..@@..@......@..@.@@..@@.@..@@..@
@........@.@........@.@......@@@.......@@@......@.....@..@@...@..@.....@.@....@....@..@@
@........@...@........@@.......@.@....@@@..........@@...@.@...@@...@.@...@........@@@@@@
@@.....@@@@@@.........@@..@....@@..@....@.@.....@..@@.@@@.@.@.@@@@.@.........@.@..@@.@.@
@.@.@..@.@...@.@@..@..@.....@@.@..@.@.@@@@@...@@@..@..@........@@.@@..@@.....@@.@@@@.@@@
@@@@@@..@@@@@@@@@@...@@@.@@@@@@@@@@@@@@@@@@..@@@@@@@@@@@@@@@@@@@@@@@@@@@@@@@@@....@....@
@..@@.@.......@..@..@@......@..@....@.....@....@.@.@@.@@.@...@....@...@............@...@
@......@.@.@.@@@@@@..@@..@@....@.@...@@@@..@...@....@@..@...@@..@.@...............@@.@.@
@.@.@....@@..@...@@..@....@..@.@..........@....@@@@@@@@..@@...@@..@.....@...@@.@....@..@
@...@..@...@..@@.@....@@@@....@...@....@..@@@..@@....@@@..@..@.@@.@@.@.....@@@...@.....@
@@....@..@..@.....@.@..@@.@@...@.@..@...@@...@.@..@......@........@..@.@@...@...@.@..@@@
@..@....@...@.....@..@@@......@...@@@@.........@@@@@@@@@@@@@@@@@@@@@@@@@@@@@@@@@@@@@@@@@
@@@@@@@@@@@@@@@@@@...@.@@........@@@@.......@...@..@.....@@.........@.@....@@@......@..@
@...@.@.@....@.....@.@.@@@@............@.@...........@.@@@.......@..@..@@.....@@@....@.@
@@....@.....@.@..@@........@@.@.@....@...@.....@@@@.....@...@......@@.@....@....@..@..@@
@..@@@@.@@.@.....@......@..@..@.@.........@..@.@.@.@....@...@.........@...@.....@...@..@
@....@...@..@....@....@..@......@@...@@........@.....@...........@@@...@.@.@.......@@..@
@@@@@@@@@@@@@@@@@@....@..@@@@@@@@@@@@@.@.@.....@@.....@.@@.......@@.....@@.@@.....@...@@
@......@.......@.@....@@..@.@@@.@....@@..@....@@.@.@@.........@.@@..@..@.@..@..@@......@
@.@@@.@...@......@........@@.....@..@@@.....@@.@@@@@@@@@@@@@@@@@@@@@@@@@@@@@@@@@@@@@@@@@
@...@......@..@..@@.......@.@@.......@@.@..@.@@...@.@.........@.....@..@.@@..@...@...@.@
@@............@.@@..@..@@.@.....@.@@@@.@.@....@.@....@.@...@..@.......@@.....@..@......@
@@@..@.@@.@.@@.@.@........@@.......@.@.......@.@..@@.@....@@.....@@@@...@.@.@@@.....@..@
@.......@..@.@...@..@.....@.@.@.@....@@@@......@@@@.@@@@....@@..@..@..@...........@@...@
@@@@@@@@@@@@@@@@@@..@@@..@@.....@...@@....@....@.....@@@.....@...@...@.....@.......@@@.@
@........@..@...@.....@@@@@..........@@@.......@....@..................@.@.@...@@.....@@
@....@.@.@....@.@........@@.@.@.@..@@@..@.@..@@@@@@.......@.....@@@..@.........@......@@
@.....@..........@...@@.@@@@@@@@@@@@@@.@@..@.@.@@@@@@@@@@@@@@@@@@@@@@@@@@@@@@@@@@@@@@@@@
@......@@@.@.@..@@..@..@@@@@.......@.@@..@@..@...@@..@....@.@.....@@.......@....@..@.@@@
@.@..@.@.@....@@.@@......@@@@.@....@@@.@.@...@..@.............@..@..@......@@.@.@......@
@..@...@@.....@.@@...@....@.@........@..@...@@.@..@......@@..@@.@@..@.@....@.@..@..@...@
@@@@@@@@@@@@@@@@@@@@..@@..@...@.@..@.@@.......@@@@......@.@...@..........@..@@.@@......@
@.@.@@....@@@....@..@.@..@@.@.@....@.@....@....@@.......@.@.@@.@@...@.@.@..............@
@..@.@.@.@....@@.@.....@@.@....@...@@@...@.@...@...@.@.@......@.....@@....@@...@@@....@@
@@@.@@.@..@..@...@@@......@@.@.@@....@...@.....@...@..@@.@.@....@.@@@...@.@.....@......@
@..@..@.@.@.@....@........@@.......@@@....@....@@@@@@@@@@@@@@@@@@@@@@@@@@@@@@@@@@@@@@@@@
@.@@..@......@@@.@.@.@@...@@...@.....@...@@..@.@@@....@.@...@..@@...@@...@.@....@..@.@.@
@...@...@@@@...@.@@.@...@.@....@.....@@.@.@..@.....@@.......@.@.@@..@.....@..@..@.@.@.@@
@...@.@@.@.@@..@....@.@....@.........@...@@.@..@..@..@....@........@@..@........@.@....@
@@.@....@@...@....@.....@@.@..@@@.@..@@....@@..@....@...@.........@.@..@....@.......@@@@
@@@@@@@@@@@@@@@@@@@..@.@@@.@..@.....@@@....@@..@@.@@@@..@.@..@@..@....@.@...@@...@.@@..@
@.@......@.@...@@@.@.....@@@.@..@....@..@@@....@...@.@.@@@@@.....@@...@....@...@.......@
@..@..@......@...@..@@.............@.@..@@.@@..@....@.@.@..@.@.@..@.@.......@.@.@@.....@
@@@@..@@@.@@.@@.@@........@...@@.....@...@.@...@........@.@@...@@.@.......@......@.....@
@.@...@@@..@.....@....@.@.@@.....@...@@......@.@@@@@@@@@@@@@@@@@@@@@@@@@@@@@@@@@@@@@@@@@
@.@@...@..@@@...@@....@@..@@..@@.@...@....@@.@@@.@..@......@...@@...@@..@....@..@...@..@
@@@@@@..@.@.@.@@@@..@.....@...@..@...@@@..@.@@.@.@@@.@@....@.....@.@...@..@..@....@....@
@..@.@...@@.....@.......@@@@@@..@...@@.@..@@@.........@.@......@.@.......@........@..@.@
@@@@@@@@@@@@@@@@@@..@....@@.......@.@@..@..@..@.......@.@........@@.@.@....@@...@@.@.@.@
@..@....@@@..@.@..@@...@.@@.@@@.@.@..@...@.....@@@....@@....@.@.@...@...@@@@.@....@@.@.@
@.@...........@..@@@......@..@@@..@.@@.@..@....@@@..@@@.@.@..@@....@.@...@.....@..@@.@@@
@.@@.......@@.@@@@.@.....@@@@@@@@@@@@@.@...@...@..@@.@@@......@...@@.......@......@.@..@
@.@...@.....@@...@..@@...@@........@.@.@..@..@.@@......@..@@.@...@....@...@.@..@..@....@
@..@.@...@@...@..@........@..@...@.@.@....@.@@@@@@@@@@@@@@@@@@@@@@@@@@@@@@@@@@@@@@@@@@@@
@@....@@@..@...@.@@.@@..@.@.@@@.@....@@......@@@..@@....@...@@@@.@@.@@..@.@....@....@@@@
@@.@@@.....@..@.@@......@.@....@.@...@.@.@........@...@@.@....@...@.@@@..@@..@.@@......@
@.....@@@.@...@..@@..@....@.@....@..@.@......@..@.@@..@....@@.@@@..@@........@@........@
@.@@@..@@.@......@......@.@@@@.@......@.@@.@@...@.@.......@...@.....@.....@.@@.@...@..@@
@@@@@@@@@@@@@@@@@@...@@@@.@..@..@@....@@.@..@..@.@.......@.@......@.@.@.........@@...@.@
@@...@.....@.....@..@.@@.@@.@....@@...@........@@.....@...@....@..@.@...@@@...@..@..@..@
@@......@.....@.@@@@.@.@..@....@@..@@@....@....@..@...@@...@@.@....@@..@........@@..@@.@
@@.@...@.........@......@.@.......@@.@....@.@..@@.@@.@@.@@..@@....@.@..@.@..@....@.....@
@@........@@....@@...@.@..@@.....@@.@@..@@@...@@.......@....@.@@..@.@@....@.@...@@..@..@
@.......@........@.@....@.@@@@@@@@@@@@..@....@.@......@.......@..@..@@.@@........@..@..@
@@@....@...@.@@..@..@....@.@.@@....@..@...@@@..@@@@@@@@@@@@@@@@@@@@@@@@@@@@.@.@...@@@@@@
@....@....@....@.@.......................@.@...@.....@@.....@...@.@.@.@@@.@...@.....@..@
@...@@@.....@....@@..@@.@.....@.....@.......@.@@@..@..@..@.@@......@..@.@.@@..@@.......@
@@@@..@.@..@.....@.@.......@...@@.....@.@@..@@.@@@@.....@...@....@..@..@.@..@..@..@....@
@....@....@......@.@.....@...@...@@..@@.@.....@@@....@..@...@........@@..@@.........@..@
@..@..@....@@@...@@.@@...@.........@.@.@.@..@@.@@@@@.@..@@@@@@@@@@@@@@@@.@@...@.@@@@@@@@
@@@@@@@@@@@@@@@@@@@@@.......@.........@@.......@....@..@@...@@..@.@@@@..@..@@.@..@...@.@
@....@...@.@....@@..@...@..@@@...@@..@......@@.@.@..@.@.@@.....@@..@...@..@.......@@...@
@...@....@@@...@@@....@.@..@..@......@...@....@@.@...@@.@...@..@@.............@@@......@
@.@........@..@..@@.....@............@@...@...@......@...@.......@....@..@........@..@.@
@..@.@......@....@@...@..........@@@@.......@.......@.@.@...@...@.@........@@@.@@...@..@
@.....@@....@@...@.....@@...@....@....@.@..@......@..@..@.....@@@@@@@.....@..@@@@@....@@
@...@...@....@@@@.@@@@.@..@@....@@.@@....@....@.@.@..@..@@.......@.@...@@@...@.@...@...@
@@@@@@@@@@@@@@@@@@@@@@@@@@..@..@@@@@@@@@@@..@..@@@@@@@@@@@.@..@..@@@@@@@...@......@..@.@
@....@..@.@....................@.@.@.@@..@.....@@@...@@.@@..@@...@..@..@......@........@
@@.............@...@.@@........@@.@.@.....@....@.....@.@.@...@@.@@...@.....@....@..@...@
@..@@.@..@@........@...@.@...@.@.@......@.@....@@...@....@@......@..@.@....@.@.@@......@
@@.@..........@..@..@..........@@@.@....@.@@.@.@@....@@...@......@.....@......@...@@...@
@@.......@..@....@..@.@.@@....@@.....@.@..@....@@...@@..@.....@.@@..@.@..@.@.@@.....@..@
@@.@@.@@.....@.@@.....@.@@@....@@..@.@..@...@..@........@..@.@@..@....@...@.@...@.@..@.@
@@@@@@@@@@@@@@@@@@@@@@@@@@@@@@@@@@@@@@@@@@@@@@@@@@@@@@@@@@@@@@@@@@@@@@@@@@@@@@@@@@@@@@@@
